[id,id_number]
Types=types0,types1
BaseStats=hp,attack,defense,speed,special_attack,special_defense
BaseEXP=base_EXP
EVs=HP,hp,ATTACK,attack,DEFENSE,defense,SPEED,speed,SPECIAL_ATTACK,special_attack,SPECIAL_DEFENSE,special_defense
CatchRate=catch_rate
Happiness=happiness
Abilities=abilities0,abilities1
HiddenAbility=hidden_ability0,hidden_ability1
Moves=moves0left,moves0right,moves1left,moves1right
TutorMoves=tutor_moves0,tutor_moves1
EggMoves=egg_moves0,egg_moves1
EggGroups=egg_groups0,egg_groups1
HatchSteps=hatch_steps
Offspring=offspring0,offspring1
Height=height
Weight=weight
Color=color
Shape=shape
Habitat=habitat
Category=category
Pokedex=pokedex
FormNames=form_names0,form_names1
Generation=generation
Flags=flags0,flags1
WildItemCommon=wild_item_common
WildItemUncommon=wild_item_uncommon
WildItemRare=wild_item_rare
Evolutions=name,method,evolution_parameter
MegaStone=mega_stone
UnmegaForm=unmega_form
MegaMove=mega_move
MegaMessage=mega_message
PokedexForm=pokedex_form
