[id]
Name=name
InternalName=internal_name
Type1=type1
Type2=type2
BaseStats=hp,attack,defense,speed,special_attack,special_defense
GenderRate=gender_rate
GrowthRate=growth_rate
BaseEXP=base_EXP
EffortPoints=hp,attack,defense,speed,special_attack,special_defense
Rareness=rareness
Happiness=happiness
Abilities=abilities0,abilities1
HiddenAbility=hidden_ability0,hidden_ability1
FormNames=form_names0,form_names1
Moves=moves0left,moves0right,moves1left,moves1right
EggMoves=egg_moves0,egg_moves1
Compatibility=compatibility0,compatibility1
StepsToHatch=steps_to_hatch
Height=height
Weight=weight
Color=color
Habitat=habitat
Kind=kind
Pokedex=pokedex
RegionalNumbers=regional_numbers0,regional_numbers1
WildItemCommon=wild_item_common
WildItemUncommon=wild_item_uncommon
WildItemRare=wild_item_rare
BattlerPlayerX=battler_player_x
BattlerPlayerY=battler_player_y
BattlerEnemyX=battler_enemy_x
BattlerEnemyY=battler_enemy_y
BattlerShadowX=battler_shadow_x
BattlerShadowSize=battler_shadow_size
BattlerAltitude=battler_altitude
Evolutions=name,method,evolution_parameter
Incense=incense
Shape=shape
